  ____    ___     _____ _   _  ____   _   _ _   _ __  __    _    _   _ ___ _______   __        
 / ___|  / \ \   / /_ _| \ | |/ ___| | | | | | | |  \/  |  / \  | \ | |_ _|_   _\ \ / /        
 \___ \ / _ \ \ / / | ||  \| | |  _  | |_| | | | | |\/| | / _ \ |  \| || |  | |  \ V /         
  ___) / ___ \ V /  | || |\  | |_| | |  _  | |_| | |  | |/ ___ \| |\  || |  | |   | |    _   _ 
 |____/_/   \_\_/  |___|_| \_|\____| |_| |_|\___/|_|  |_/_/   \_\_| \_|___| |_|   |_|   (_) (_)